NO ./maps/texture/wall_north.xpm
SO ./maps/texture/wall_south.xpm
WE ./maps/texture/wall_west.xpm
EA ./maps/texture/wall_east.xpm

F 220,100,0
C 225,30,100

        1111111111111111111111111
        1000000000110000000000000
        1011000001110000000000000
        1001000000000000000000000
111111111011000001110000000000000
100000000011000001110111111111111
11110111111111011100000010000
11110111111111011101010010000
11000000110101011100000010000
10000000000000001100000010000
10000000000000001101010010000
11000001110101011111011110N0111
11110111 1110101 101111010000
11111111 1111111 111111111111
