NO ./maps/texture/wall_north.xpm
SO ./maps/texture/wall_south.xpm
WE ./maps/texture/wall_west.xpm
EA ./maps/texture/wall_east.xpm

F 220,100,0
C 225,30,100

11111111111111
10000000000001
 0000000N00001
10000000000001
11111111111111
