NO ./maps/texture/wall_north.xpm
SO ./maps/texture/wall_south.xpm
WE ./maps/texture/wall_west.xpm
EA ./maps/texture/wall_east.xpm

F 220,100,0
C 225,30,100

        1111111111111111111111111
        1000000000110000000000001
        1011000001110000000000001
        1001000000000000000000001
11111111011000001110000000000001
000000000011000001110111111111111
01110111111111011100000010001
01110111111111011101010010001
01000000110101011100000010001
00000000000000001100000010001
00000000000000001101010010001
01000001110101011111011110N0111
01110111 1110101 101111010001
11111111 1111111 111111111111
